000000000000000
031111111111140
011111131113110
011111111111110
011111131111310
011111311111110
011111111311110
011311111311110
011311131111110
011311111111110
011111111111110
011111113111110
011331113111110
011331111111110
011111113111110
011113111111110
011111111131110
011311111131110
011111111111110
000000000000000